#######################
#######################
#######################
#######################
#######...#############
#######..##.#.##############
#######.##..###..###########
#########........###########
########...@..#.....########
#############.#########
#############.#########
#############.#########
#############.#########
##########..#.#..##.########
#######..#..#....##.########
#######.##.##.#.##..########
#######.#......##..########
#######.#.....##..########
#######.###.###..########
#######...#.##..#######
#######################
#######################
#######################
#######################